111111111111111111111111111
10000C00000100000000C000001
1000000C0001000000000000001
10000000000100000C000000001
10000000C000000000000000001
100000P00000010000000000001
1000C0000000010000001000001
1000010000000000C0001000001
10000100C000000C00001000001
100100000011110000000001001
1100100C001000000C001000011
1E0001000010C00000001000001
111111111111111111111111111