11111111111111111111111111111111111111
1000C0C0C00000C0000000C100000000001001
10000100000000000000010000000C00000001
1000001000000000000001000000C000000001
10000100000000000000010000000000000001
10000100000000000000010C00000000000001
1000000C000000000000001111110000000001
1000000000011110C000000000100000000001
1000000000000010000000000C100000000001
100000C000000001000C000000111111000001
1000000000000001111110C000000001000001
1E000P0000000000000010C000000C01000C01
11111111111111111111111111111111111111